1111111111111111111
1000000000100000001
1110111110111011101
1000000010001000101
1011111011101010101
1000001000001010001
1111101111111010111
1000001000001010001
1110101011101011101
1000100000100000101
1011111110111110101
1010000010100010001
1010101110101011101
1000100000001000001
1111111111111111111
